AAF: As A Friend
ADAD: Another Day Another Dollar
ADIH: Another Day In Hell
ADIP: Another Day in Paradise
AEAP: As Early As Possible
AFAICR: As far as I can recall / remember
AFAICS: As far as I can see
AFAICT: As far as I can tell
AFAIK: As far as I know
AFAIR: As far as I remember
AFAP: As Far As Possible
AFK: Away from keyboard
ALOL: Actually laughing out loud
ASAP: As soon as possible
ASL: Age / sex / location
ASLP: Age, sex, location, picture
ATEOTD: At The End of the Day
ATB: All the best
ATM: At the moment
AWOL: Absent Without (Official) Leave
AYBABTU: all your base are belong to us (from the video game Zero Wing)
AYB: 
B2B: Business to Business
B2C: Business to Customer
B4: Before
BBIAB: Be back in a bit
BBQ: Barbecue.
BBL: Be back later
BBS: Be back soon
BCNU: Be seein' you
BFF: Best Friends Forever
BFN: Bye For Now
BOFH: Bastard operator from hell
BRB: Be right back
BSOD: Blue Screen of Death
BTDT: Been there done that
BTW: By the way
bump: Increment (for example, C's ++ operator.) or a backronym for "Bring Up My Post"
CMIIW: Correct me if I'm wrong.
CU: See you (later)
CYA: See ya OR Cover Your Ass
DFTT: Don't feed the trolls
DFTBA: Don't forget to be awesome
DGAF: Don't give a fuck
DIAF: Die in a fire
DILLIGAF: Does it look like I give a flip / fuck / damn / shit
DILLIGAD: Does it look like I give a  damn
DILLIGAS: Does it look like I give a  shit
DL: Download
DND: Do not disturb
DOA: Dead on arrival. Refers to hardware that is broken on delivery.
EOF: End of File
EOM: End of Message
EOL: End of Life (device or hardware that is at the end of its product life cycle) OR End of Line.
EQ: EverQuest
ESAD: eat shit and die
ETA: Estimated time of arrival
F9: Fine
FAQ: Frequently Asked Question(s)
FFS: For fuck's sake
FMCDH: From My Cold Dead Hands
FML: Fuck my life.
FOAD: Fuck off and die
FOAF: Friend of a friend
FTFY: Fixed that for you
FTL: For the loss
FTW: For the win
FTW?: Fuck the what? (reversal of WTF?, implies increased confusion)
FU: Fuck you
FUBAR: Fucked up beyond all recognition / repair (from military slang; pronounced "foo-bar")
FUD: Fear, Uncertainty and Doubt (the purposeful spread of misinformation)
FWIW: For what it's worth
FYI: For your information
GBTW: Get back to work
GF: Great/good fight
GFU: Good for you
GFY: Go fuck yourself
GG: Good game, used at or near the conclusion of a gaming match
GGS: Good games
GJ: Good job, 
GL: Good luck, used before commencing a game
GMTA: Great minds think alike
gratz: Congratulations
GTFO: Get the fuck out
GTG or G2G: 'Got to go' or 'Good to go'
GR: Good Race
HAND: have a nice day
HF: Have fun
HTH: Hope this / that helps
IANAL: I am not a lawyer
IBTL: In before the lock
IDK: I don't know
IHT: I had to
IONO: I don't know
IIRC: If I recall / remember correctly
IIUC: If I understand correctly
ILY: I love you
IMO: In my opinion
IMHO: In my humble / honest opinion
IMNSHO: In my not so humble opinion
IMAO: In my arrogant opinion
IOW: In other words
IRC: Internet Relay Chat
IRL: In real life
ISTM: It seems to me
ITYM: I Think You Mean
IWSN: I want sex now
IYKWIM: If you know what I mean
IZI: Easy (French-speaking, from the group 92i)
jaggy: aliased computer graphics
JAS: Just a sec
JFTR: Just for the record
JK: Just kidding, or joke
k: OK
kk: OK
KISS: Keep it simple stupid.
KOS: Kill on sight
KTHX: OK, thanks
kthxbye: OK, thanks, goodbye
l8r: Later, L8R also sometimes abbreviated as L8ER is commonly used in chat rooms and other text based communications as a way of saying good bye.
lag: Slang term for slow Internet speeds or high Internet latency; Lag is sometimes due to a server problem, but more frequently due to the connection between client and server. A slow or intermittent connection may often be referred to as laggy
lamer: A know-nothing, one who is lame.
leet: Often spelled as l33t or 1337. It originally meant elite
LFG: Looking for group
LFM: Looking for more
LMAO: Laughing my ass off
LMBO: Laughing my butt off
LMFAO: Laughing my fucking ass off
LMGTFY: Let me Google that for you
LMIRL: Let's meet in real life.
LMK: Let me know
LOL: Laughing out loud, laugh out loud
LTNS: Long time no see
lulz: Corruption of LOL
lurker: Someone who frequents a community or group without participating in discussions
LYLAB: Love you like a brother.
LYLAS: Love you like a sister.
MFW: My face when (Usually accompanied by an image)
MMO: Massive Multi-player Online [game]
MMORPG: MMO + RPG (Massive Multi-player Online Role-Playing Game). 
MOTD: Message of the day
MTFBWY: May The Force be with you
MUD: Multi-User Dungeon
MUSH: Multi-User Shared Hallucination
MYOB: Mind your own business
M8: Mate
N1: Nice one, used mostly often in gaming
NE1: "Anyone"
newbie:
newb:
n00b: An inexperienced user of a system or game, or an annoying person. 
NGL: Not gonna lie
NIFOC: Naked In Front Of Computer
NM: (Sometimes written N/M) Not much, Never mind or no message, 
n0rp: Alternate form of pr0n, intentional misspelling of porn
NP: No problem
NS: Nice shot. Used in online gaming.
NSOH: No sense of humor.
NSFW: Not safe for work
NVM:
NVMD:
nm: Nevermind, not much
RLY: Oh really?
OIC: Oh, I see
OFN: Old freaking news
OMG: Oh my god
OMFG: Oh my fucking god
OMGWTF: Oh my God what the fuck
OMW: On my way or Oh my word
ONOZ: Oh, no
OP: Original poster / Operator / Outpost
OS: Operating system
OT: Off topic
OTB: Off to bed
OTOH: On the other hand
OTP: On the phone or One true pairing or On The PissO RLY: Oh really?
P2P: Peer to peer, or pay to play
PAW: Parents are watching
PEBKAC:
PEBCAK: Problem exists between keyboard and chair
PITA: Pain in the arse / ass
PLMK: Please let me know
PMSL: Pissing myself laughing
POS: Piece of shit, or parent over shoulder.
POTS: Plain old telephone service
POV: Point of view
PL: Powerleveling, used in online games.
PPL: People
PTKFGS: Punch the Keys For God's Sake
pr0n: Intentional misspelling of porn
PW: Persistent World (gaming)
pwned: Intentional misspelling of owned
QFT: Quoted for truthiness—either to show satire or agreement with something satiric.
QWP: (texting) Quit Whining, Please. (gaming) equip verb / equipment noun.
rehi (or merely re): Hello again
RL: Real Life
RMS: Ride me sideways
ROFL:
ROTFL: Rolling on (the) floor laughing
ROFLMAO:
ROTFLMAO: Rolling on (the) floor laughing my ass off
ROFLMAOWPIMP:
ROTFLMAOWPIMP: Rolling on (the) floor laughing my ass off while peeing in my pants
ROFLOL:
ROTFLOL: Rolling on (the) floor laughing out loud
RSN: Real soon now (used sarcastically)
RTFB: Read the fucking binary (or book)
RTFS: Read the fucking source
RTFM:
RTM: Read the (fucking/fine) manual or reboot the (fucking) machine
SCNR: Sorry, could not resist
SFW: Safe for Work, see NSFW
sk8:
sk8r:
sk8er: skate/skater
smiley: Another name for emoticons
SMH: Shaking my head
SNAFU: Situation normal: all (fucked/fouled) up
snail mail: Normal paper mail service
SOHF: Sense of humor failure
SOS: Someone (watching) Over Shoulder
STFU: Shut the fuck up
STFW: Search the fucking web
TANSTAAFL: There ain't no such thing as a free lunch
TBF: Time between failures
TBH: To be honest
TG: That's great
TGIF: Thank God it's Friday
THX:
THNX:
TNX:
TX: Thanks
TIA: Thanks in advance
TIL: Today I learned
TIMWTK: This inquiring mind wants to know
TINC: There Is No Cabal, a term discouraging conspiracy theories
TINS: There is no spoon
TLDR: Too Long; Didn't Read
TMI: Too much information
toobs: Internets (refering to the Internet as a series of tubes)
TOS: Terms of service
TTBOMK: To the best of my knowledge
TTFN: Ta ta for now
TTYL: Talk to you later (also spelled TTUL, T2UL or T2YL)
TTYN: Talk to you never
TTYS: Talk to you soon
TY: Thank you
TYT: Take your time
TYVM: Thank you very much
U: You
UTFSE: Use the fucking search engine
UGO: You got Owned
URS: You Really Suck
w00t:
w00T:
WOOT: "We Own the Other Team".
WO: without
WB: Welcome back
WBU: What (a)bout you
WE: Whatever
WE: Weekend
WRT: With respect / regard to
WTB: Want to buy
WTF: What the fuck
WTG: Way to go
WTH: What the hell
WTS: Want to sell
WTT: Want to trade
WUG: What you got?
WUBU2: What (have) you been up to?
WUU2: What (are) you up to?
WYSIWYG: What you see is what you get
W8: Wait
xox:
xoxo:
YAGNI: You Ain't Gonna Need It.
YAGTOH: you are going to own him.
YGM: You've Got Mail.
YHBT: You have been trolled.
YEC: Young Earth Creationism
YKW: You know what?
YMMV: Your mileage may vary.
YOLO: You Only Live Once.
YOYO: You're On Your Own.
YTMND: You're The Man Now, Dog
YW: You're welcome.
zomg: